key	text	english
Babylon	Daniel 2Â :32, 36-38 ; 7:4	Daniel 2:32, 36-38; 7:4
Medopersia	Daniel 2:32, 39 ; 7:5	Daniel 2:32, 39; 7:5
Greece	Daniel 2:32, 39 ; 7:6	Daniel 2:32, 39; 7:6
Rome	Daniel 2:33, 40 ; 7:7	Daniel 2:33, 40; 7:7
Angloamerica	Daniel 2:33, 41-43	Daniel 2:33, 41-43
Babylon_c	Babylone	Babylon
Medopersia_c	MÃ©do-Perse	Medo-Persia
Greece_c	GrÃ¨ce	Greece
Rome_c	Rome	Rome
Angloamerica_c	Anglo-AmÃ©rique	Anglo-America
infliction1	400 ans d'infliction	400 year infliction
infliction2	Actes 7:6	Acts 7:6
Jacob2	Jacob/	Jacob/
Israel	IsraÃ«l	Israel
Sarah	Sarah	Sarah
Hagar	Agar	Hagar
Haran	Haran	Haran
Nahor	Nahor	Nahor
Reumah	Reumah	Reumah
Milcah	Milca	Milcah
Lot	Parcelle	Lot
Lots_wife	La femme de Lot	Lotâ€™s wife
Lots_daughters	Filles de Lot	Daughters of Lot
Moab	Moab (fille aÃ®nÃ©e)	Moab (older daughter)
Ammon	Ben Ammi (Ammon)	Ben-ammi (Ammon)
Bethuel	Bethuel	BeÂ·thuel
Rebekah	RÃ©becca	Rebekah
Laban	Laban	Laban
Leah	Horrible	Leah
Rachel	Rachel	Rachel
Bilhah	Bilhah	Bilhah
Zilpah	Zilpa	Zilpah
Reuben	Ruben	Reuben
Simeon	SimÃ©on	SimeÂ·on
Levi	LÃ©vi	Levi
Judah	Juda	Judah
Issachar	IssaÂ·char	IssaÂ·char
Zebulun	Zebulon	ZebuÂ·lun
Dinah	Dinah	Dinah
Esau	Ã‰saÃ¼	Esau
Ishmael	IsmaÃ«l	Ishmael
Manasseh2	(ManassÃ©	(Manasseh
Ephraim	et Ã‰phraÃ¯m)	and Ephraim)
Benjamin	Benjamin	Benjamin
Dan	Dan	Dan
Naphtali	Naphtali	NaphtaÂ·li
Gad 	Dieu	Gad
Asher	Asher	Asher
Milcah1	Uz, Buz, Kemuel,	Uz, Buz, Kemuel,
Milcah2	Chesed, Hazo,	Chesed, Hazo,
Milcah3	Pildash, Jidlaph	Pildash, Jidlaph
Tebah	Tebah	Tebah
Gaham	Gaham	Gaham
Tahash	Tahash	Tahash
Maacah	Maaca	Maacah
Mahalath	Mahalath/	Mahalath/
Basemath	Base Â· mathÃ©matiques	BaseÂ·math
Reuel	RÃ©uel	Reuel
Nahath	Nahath	Nahath
Zerah	ZÃ©rah	Zerah
Schammah	Schammah	Schammah
Mizzah	Mizza	Mizzah
Adah	Ada	Adah
Eliphaz	Ã‰liphaz	Eliphaz
Teman	ThÃ©man	Teman
Omar	Omar	Omar
Zepho	ZÃ©pho	Zepho
Kenaz	KÃ©naz	Kenaz
Korah	CorÃ©	Korah
Gatam	Gatam	Gatam
Amalek	Amalec	Amalek
Oholibamah	OÂ·holÂ·iÂ·bamah	OÂ·holÂ·iÂ·bamah
Jeush	Jeush	Jeush
Jalam	Jalam	Jalam
Korah	CorÃ©	Korah
Nebaioth	NÃ©baioth	Nebaioth
Kedar	KÃ©dar	Kedar
Adbeel	AdbÃ©el	Adbeel
Mibsam	Mibsam	Mibsam
Mishma	Michma	Mishma
Dumah	Douma	Dumah
Massa	Massa	Massa
Hadad	Hadad	Hadad
Tema	ThÃ¨me	Tema
Jetur	Jetur	Jetur
Naphish	Naphish	Naphish
Kedemah	Kedemah	Kedemah
Babylon2	grand-mÃ¨re	
terahfam	membres de la famille de Terah	members of Terahâ€™s family
rosetta	Pierre de Rosette 196 avant notre Ã¨re.	Rosetta stone 196 B.C.E.
Herodotus	HÃ©rodote c. 484 â€“ ch. 425 avant notre Ã¨re	Herodotus c. 484 â€“ c. 425 B.C.E.
Aristotle	Aristote 384 â€“ 322 avant JC	Aristotle 384 â€“ 322 BC
Ptolemy	PtolÃ©mÃ©e c 100 â€“ c. 170 de notre Ã¨re	Ptolemy c 100 â€“ c. 170 C.E.
Pythagoras	Pythagore v. 570 â€“ vers. 495 avant JC	Pythagoras c. 570 â€“ c. 495 BC
Plato	Platon c. 427 â€“ ch. 348 avant JC	Plato c. 427 â€“ c. 348 BC
Socrates	Socrate c. 470 â€“ vers. 399 avant JC	Socrates c. 470 â€“ c. 399 BC
Josephus	JosÃ¨phe c. 37 â€“ ch. 100 de notre Ã¨re	Josephus c. 37 â€“ c. 100 C.E.
Cicero	CicÃ©ron 106-43 avant JC	Cicero 106â€“43 BC
lachish_letters	Lettres de Lachish c. 590 avant notre Ã¨re	Lachish letters c. 590 B.C.E.
lachish_reliefs	Reliefs de Lachish c. 681 avant notre Ã¨re	Lachish reliefs c. 681 B.C.E.
mesha_stele	StÃ¨le de Mesha (pierre moabite) v. 840 avant notre Ã¨re	Mesha Stele (Moabite stone) c. 840 B.C.E.
gilgamesh	Gilgamesh et Aga ğ’‡½ğ’†¥ğ’„„ğ’€€ğ’€ğ’‚µ	Gilgamesh and Aga ğ’‡½ğ’†¥ğ’„„ğ’€€ğ’€ğ’‚µ
epic_gilgamesh	Ã‰popÃ©e de Gilgamesh (SÃ®n-lÄ“qi-unninni)	Epic of Gilgamesh (SÃ®n-lÄ“qi-unninni)
oxyrhynchus	Papyrus Oxyrhynchus	Oxyrhynchus Papyri
p52	Papyrus P52 de la bibliothÃ¨que Rylands	Rylands Library Papyrus P52
daniel2_1	Le roi Nabuchodonosor	King Nebuchadnezzar
daniel2_2	dÃ©truit JÃ©rusalem	destroys Jerusalem
daniel2_3	Conquiert Babylone	Conquers Babylon
daniel2_4	Cyrus dÃ©crÃ¨te le retour	Cyrus decrees return
daniel2_5	des Juifs Ã  JÃ©rusalem	of Jews to Jerusalem
daniel2_6	Alexandre le Grand	Alexander the Great
daniel2_7	conquiert la Perse	conquers Persia
daniel2_8	RÃ¨gles sur IsraÃ«l	Rules over Israel
daniel2_9	DÃ©truit JÃ©rusalem	Destroys Jerusalem
daniel2_10	Pendant la PremiÃ¨re Guerre mondiale,	During World War I,
daniel2_11	Puissance mondiale anglo-amÃ©ricaine	Anglo-American World Power
daniel2_12	prend naissance	comes into being
